XXOOOOOOOOOXX
XOOOOOOOOOOOX
OOOOOOOOOOOOO
OXOXOXOXOXOXO
OOOOOOOOOOOOO
OXOXOXOXOXOXO
OOOOOOOOOOOOO
OXOXOXOXOXOXO
OOOOOOOOOOOOO
XOOOOOOOOOOOX
XXOOOOOOOOOXX